[[0.   0.   0.  ]
 [0.   0.   0.  ]
 [0.   0.   0.  ]
 [0.   0.   0.  ]
 [0.   0.   0.  ]
 [0.   0.   0.  ]
 [0.   0.   0.  ]
 [0.   0.   0.  ]
 [0.   0.   0.  ]
 [0.   0.   0.  ]
 [0.   0.   0.  ]
 [0.   0.   0.  ]
 [0.   0.   0.  ]
 [0.   0.   0.  ]
 [0.   0.   0.  ]
 [0.   0.   0.  ]
 [0.   0.   0.  ]
 [0.   0.   0.  ]
 [0.   0.   0.  ]
 [0.   0.   0.  ]
 [0.   0.   0.  ]
 [0.   0.   0.  ]
 [0.   0.   0.  ]
 [0.   0.   0.  ]
 [0.   0.   0.  ]
 [0.   0.   0.  ]
 [0.   0.   0.  ]
 [0.   0.   0.  ]
 [1.   1.   0.  ]
 [0.   0.   0.  ]
 [0.   0.   0.  ]
 [0.   0.   0.  ]
 [0.   0.   0.  ]
 [0.   0.   0.  ]
 [0.   0.   0.  ]
 [0.   0.   0.  ]
 [0.   0.   0.  ]
 [0.   0.   0.  ]
 [0.   0.   0.  ]
 [0.   0.   0.  ]
 [0.75 1.   0.  ]
 [0.   0.   0.  ]
 [0.   0.   0.  ]
 [0.   0.   0.  ]
 [0.   0.   0.  ]
 [0.   0.   0.  ]
 [0.   0.   0.  ]
 [0.   0.   0.  ]
 [0.   0.   0.  ]
 [0.   0.   0.  ]
 [0.   0.   0.  ]
 [0.   0.   0.  ]
 [0.   0.   0.  ]
 [0.   0.   0.  ]
 [0.   0.   0.  ]
 [0.   0.   0.  ]
 [0.   0.   0.  ]
 [0.   0.   0.  ]
 [0.   0.   0.  ]
 [0.   0.   0.  ]
 [0.   0.   0.  ]
 [0.   0.   0.  ]
 [0.   0.   0.  ]
 [0.   0.   0.  ]
 [0.   0.   0.  ]
 [0.   0.   0.  ]
 [0.   0.   0.  ]
 [0.   0.   0.  ]
 [0.   0.   0.  ]
 [0.   0.   0.  ]
 [0.   0.   0.  ]
 [0.   0.   0.  ]
 [0.   0.   0.  ]
 [0.   0.   0.  ]
 [0.   0.   0.  ]
 [0.   0.   0.  ]
 [0.   0.   0.  ]
 [0.   0.   0.  ]
 [0.   0.   0.  ]
 [0.   0.   0.  ]
 [0.   0.   0.  ]
 [0.   0.   0.  ]
 [0.   0.   0.  ]
 [0.   0.   0.  ]
 [0.   0.   0.  ]
 [0.   0.   0.  ]
 [0.   0.   0.  ]
 [0.   0.   0.  ]
 [0.   0.   0.  ]
 [0.25 1.   0.  ]
 [0.   0.   0.  ]
 [0.   0.   0.  ]
 [0.   0.   0.  ]
 [0.   0.   0.  ]
 [0.   0.   0.  ]
 [0.   0.   0.  ]
 [0.   0.   0.  ]
 [0.   0.   0.  ]
 [0.   0.   0.  ]
 [0.   0.   0.  ]]